XXXXXXXXXXXXX
RRRRRRRRRRRRR
YYYYYYYYYYYYY
BBBBBBBBBBBBB
GGGGGGGGGGGGG
PPPPPPPPPPPPP
XXXXXXXXXXXXX
XXXXXXXXXXXXX
XXXXXXXXXXXXX
RRRRRRRRRRRRR
YYYYYYYYYYYYY
BBBBBBBBBBBBB
GGGGGGGGGGGGG
PPPPPPPPPPPPP
XXXXXXXXXXXXX