GGGGGGGGGGGGG
GGGGGGGGGGGGG
GGXXXGGGXXXGG
GGXXXGGGXXXGG
GGXXXGGGXXXGG
GGGGGXXXGGGGG
GGGGGXXXGGGGG
GGGXXXXXXXGGG
GGGXXXXXXXGGG
GGGXXGGGXXGGG
GGGXXGGGXXGGG
GGGGGGGGGGGGG
GGGGGGGGGGGGG