XXXRRRRRXXXX
XXRRRRRRRRRX
XXGGGYYPYXXX
XGYGYYYPYYYX
XGYGGYYYPYYY
XXGYYYYPPPPX
XXXYYYYYYXXX
XXRRBRRBRRXX
XRRRBRRBRRRX
RRRRBBBBRRRR
YYRBYBBYBRYY
YYYBBBBBBYYY
YYBBBBBBBBYY
XXBBBXXBBBXX
XGGGXXXXGGGX
GGGGXXXXGGGG