XXXXRRRRRXXXX
XXXRRRRRRRXXX
XXRRRRRRRRRXX
XRRYRYRYRYRRX
RRRRRRRRRRRRR
XXRRRXRXRRRXX
XXXRXXXXXRXXX
XXXYXXXXXYXXX
XXXXYXXXYXXXX
XXXYYYYYYYXXX
XXYYXYYYXYYXX
XYYYYYYYYYYYX
XYXYYYYYYYXYX
XYXYXXXXXYXYX
XXXXYYXYYXXXX
