XXXXXXRRRXXX
XXXXXRRRRRXX
XXXXXRGGGGXX
XXXRRRRRRRRR
XXXXRBBBBBBX
XXXXXBXBYXBX
XXXXXBBYYYBX
XYYXXBBYYYYY
YYYYXBYYYYYX
YYYYBBBBBBXX
XYYBYBBBBBBX
XXYBYBBBBBBB
XXXYBBBBBBXB
XXXXYBBBBBXX
XXXXBBBBBBBX
XXXXBBXXXBBX
XXXYYYXXXYYY